16 12 25
VV121VVVVVV1VVVV
VVVVVVVVVVVVVVVZ
VJLVVV1VVVVJL1VD
VVVVVVVVJLVVV1VD
VVVVJLVVVVVVV1VD
ZVVVVVVVVVVVVVVD
JKKLVVVVVJKLVVVD
VVVVVVVVVVVVVV2D
CVVVJKLVVVVVVVAB
FPVVVVVVVV1VVVDE
BBBCVVVVABCVVVDE
EEEFWWWWDEFWWWDE
Back.png
