24 15 80
VV1VV121VVVVV121VV1VVVVV
VVVVVVVVVVVVVV1VVVVVVV1V
V1VJKLVVVVJKLVVVVVVABCVV
ZVVVVVVVVVVVVVVVVVVGHIVV
JKKLVV1VVV21VVA11CVV1VV1
VV1VVVVVVABCVVGHHIVV2VVA
VVVVVJLVVDEFVVVVVVVV1VVG
VVVVVVVVVGHIVVVVVVVVVVVV
1VJLVV1VVVV121VVVJLVVVVZ
ZVVVVACVVVVVVVVVVVVV1VVA
LVVVVGIVVVVVVVV1VVVVKVVD
VVJLVVVVVVJLVVVKVVVKVV1D
PVVVVVVVVVVVV1VVVV1VV2AB
CVVVVVABCVVVVBVVVACVVABB
BBCWWWDEFWWWWEWWWDFWWDEE
Back.png
